NO ./textures/1.xpm
SO ./textures/2.xpm
WE ./textures/3.xpm
EA ./textures/4.xpm

C 255, 0, 0
F 0, 255, 0


        111111111111111111111111111111111111111111111111111111111111111111111
        10001000001100000000S100000000000000000000000000010000010000000000001
        101100000111000000000000001000001000000001000001010000010000000000001
        100100000000000000000000001000001000000001000001000001000000000000001
11111111101100000111000000000000000000000000000000000000000001000000000000001
10000000001100000111011111110111100011111111111111111111111111111111111111111
111101111111110111000000100011  100001
11110111111111011101010010001   100001
11000000110101011100000010001   100001
10000000000000001100000000001   100001
10000000000000001101010010001   100001
110000011101010111110111100011  100001
11110111 1110101 101111010001   100001
1000000111000001 100001111111   100001
1000000000000001110000000000111110001111111111111111111111111111111111111111
1111000000000000000000000000001110000000000000000000000000000000000000000001
1100000000000000000000000000000011111111000000000000000000000000001111111011
1111111111111111100000000001110000000000000000000000000000000000000000000001
1111111111111000000000000000000000000000000000000000000000000000000000000001
1111111111111111111111111111111111111111111111111111111111111111111111111111
