NO ./path_to_the_north_texture

SO ./path_to_the_south_texture

WE ./path_to_the_west_texture

EA ./path_to_the_east_texture

F 0,1,2

C 255,254,253







 1111
 10W1
 1111



