NO ./path_to_the_north_texture

SO ./path_to_the_south_texture

WE ./path_to_the_west_texture

EA ./path_to_the_east_texture

F 0,255,0

C 255,254,253
111111111111
100000000001
100000000001
100011100001
10001 100001
100011100001
1000000010S1
111111111111
