NO ./textures/1.xpm

SO ./textures/2.xpm

WE ./textures/3.xpm

EA ./textures/4.xpm

F 0,255,0

C 255,254,253
                            111
111111111111               1101
100000000001               1011
100000000001               1011
1000111000011111111111111111011
10001 1000000000000000000000011
1000111000000000000000000000011
1000000010S00000000000000000011
1111111111111111111111111111111
