 NO ./north
SO ./south
WE ./west
F 220,100,0
C 225,30,0

111111111111111111111111111111111111111
1N0000111111111111111111111111111111111
111111111111111111111111111111111111111
