NO    ./north

SO   ./south
  


WE ./west

EA      ./east

F     0,  255,   255

C  200,30,0


1111
10N1
1111

1111
